1
workshop - научный симпозиум
NIH - national institutes of health
pursuing - следование
Department of Energy's Office of Health and Environmental Research - Департамент энергетики по здравоохранению и экологическим исследованиям
a workshop held - сипозиум прошёл
Cold Spring Harbor Laboratory - лабораторий Колд Спринг Харбор

2
albeit - хотя
tortuous - запутанный
public policy - публичный доступ
outline(vb.) broad plan - излагать, обрисовывать общий план
HGP - human genome project
DOE - Depatment of Energy
approved reprogramming of funds - одобренный пересмотр бюджета
first line item - первая позиция?
budget submussion - предоставление бюджета
ultimately - окончательно
particular - конкретный
befriended - подружиться
chaired - возглавлять
as well - также
thereby - тем самым
agencies - орган (гос.)

3
sought - искал
obtained - получил
deputy - заместитель
chart - график
brief - показать, принести
subsequently - впоследствии

4
undertaking - мероприятий

5
memorandum of understanding - меморандум о взаимопонимании

6
comprised - состоял

7
Due to widespread - благодаря широкораспространённой
jointly - совместно
Ongoing - постоянный
essentially - по существу



Techniques

1
throughput
reveal - выявить

2
reference genome - геном, на который ссылаются



Findings

1
range - диапазон
significantly - существенно
vertebrate specific - специфичны для позвоночных



Accomplishment

1
printout - распечатка
considered - считался

2
embrace - охватить

3
ligate - перевязывать
machinery - механизм

Application

1
advancement - продвижение
forensic - судебный
animal husbandry - животноводство
bioprocessing - биопереработка
risk assessment - оценка риска

Interpretation

1
emerged - возникли
administer - управлять
predisposition - склонность
cystic fibrosis - кистозный фиброз

2
tangible - осязаемый
narrow down - сузить
examine - исследовать
yeast - дрожжи
fruit flies - плодовые мошки

3
indeed - в самом деле
illuminated - освещён

4
paved - вымостил
genetic composition - генетический состав
impacted - влияние
susceptible - восприимчивый
play out - разыгрывается
strain - штамм
yield - обеспечить
crop - урожай


CRISPR Cas9

1
specifically - конкретно, точно

2
confer - обеспечивает
plasmids and phages - плазмиды и фаги
acquired immunity - приобретённый иммунитет
harboring the spacer sequence - несущий спейсерную последовательность
RNA-guided - РНК-ориентированные

3
mint - придуман

4
the Cas9 nuclease complexed with a synthetic guide RNA - Cas 9 нуклеаза, образованная синтетической направляющей РНК
germline - зародыш

Embryos gene-editing




1
selectively - изберательно
alter - изменять
for nearly - примерно
wield - овладевать
profound - глубокий
implication - последствия
researchers and ethicists say - говорят исследователи и этики

2
enzyme - фермент
cleave - расщепляет
gluing - склеивая
cut ends - концы разреза
back together - обратно вместе

3
Whether - следует

4
hollow ball - полый шар
blastocyst - бластоциста
edited to remove the OCT4 gene - отредактированные для удаления OCT4 гена
rather than - вместо того чтобы
intentionally - намеренно
taken to extremes - в крайнем случае
extend - распространяться

Genetic rewrite

4
dulling - затупление
grasp - схватить
slice through - разрезать
attache - прикрепить